1111111111111111111111111
1P00000000C10111101011001
101C1011001001000001C0001
1100000000100000011100001
1000001100101101000000011
101101010000000C101100111
1010101010110001101100101
1100101100011011000100001
1001111010110001001101111
1010101100110110100001101
11C0000000000110100000101
1010111000000000001101001
1110010111110110100000111
11001001010011100000000C1
110C110001001010110000011
10C0000000000000000001011
10110111001110001110000E1
1101001101100111101001101
1011111110101001010111101
1111111111111111111111111