111111111111111111111111111111
1P0000000000C11010110010001111
110C01110100011010111011C00101
100000000000011100000101011101
110101011010111001000010001101
110101011000000000C01111011101
111011010010011010101011010001
101010101100001001010000000101
101100000000110011000111001101
110111000010010101010101001011
110C00000000000111110000000101
100101001000000000000000001001
100100110110100011100000001101
101001100011000110100000000C01
1000C0110111110001010011000101
111C00000000000000000000011101
1010000001101001001101100000E1
111101111001010100011000100001
100011111111100101010001000011
111111111111111111111111111111