111111111111111111
1P0000000000000001
10000C000000000001
100000C00000000001
100000000000000001
10000000C000000001
100000000000000001
100000000C00000001
100000000000000001
10000000000C000001
100000000000000E01
111111111111111111