111111111
1P1111111
11111C101
110111C11
1000000E1
111111111