11111111
1000P001
100E1C01
11111111