F 01,0,25
C 2,0,1

NO ./path_to_the_north_texture
SO ./path_to_the_south_texture
WE ./path_to_the_west_texture
EA ./path_to_the_east_texture

111111111111111111111111
1000000000110000000000001
1011000001110000000000001
1001000000000000000000001
111111110110000011100001
10000000001100000111011111111
11110111111111011100000010001
    1         1   111111 111
11110111111111011101010010001
11000000110101011100000010001
10000000000000001100000010001
10000000000000001101010010001
11000001110101011111011110W01
11110111 1110101 101111010001
11111111 1111111 111111111111